1111111111111
1000000000P01
10C0000000001
1111111111111